111111111111111111111111111111
100000000000000000000000000001
101111011111011111011111011101
100001010000010000010000010001
101101010111010111010111010101
100001010001010001010001010001
101111010111010111010111010101
1P0000010000C000100000C0000001
101111010111010111010111010101
100001010001010001010001010001
101101010111010111010111010101
100001010000010000010000010001
101111011111011111011111011101
10E000000000000000000000000001
11C101010101010101010101010101
111111111111111111111111111111
