1111111111111
1C010000000C1
1000001111001
1P0010E100001
1111111111111